Demons Are a Girl Best Friend - Powerwolf
Akai ito - Kobukuro/Yui Aragaki
Mephistopheles Return - Trans-Siberian Orchestra
The Boy Who Want To Be A Real Puppet - Sonata Arctica
Symphony of Life - Avantasia
Perfect World - TWICE
The Vengeful Onne - Disturbed
One for All, All for One - Nostradameus
Engel - Rammstein
In the Land of Twilight - Yuki Kajiura
The Devil Within - Digital Daggers
La Geografia de mi Camino - Laura Pausini
El Trino del Diablo - Tartini
Quizas - Afaz natural
La llorona - Angela Aguilar
Pharao - Freedom Call
Mascara - XG
Rocky road to Dublin - The High Kings
Tras de Mí - RBD
Welcome To The Black Parade - My Chemical Romance
Only the Broken Hearts Make You Beautiful - Sonata Arctica
The Asylum - Edguy
Therefor I Am - Bilie Eilish
Maniac - Stray Kids
To Mega Therion - Therion
The Truth Beneath the Rose - Within Temptation
La Quemona - Mishelle Master Boys
Armata Strigoi - Powerwolf
Téir Abhaile Riú - Celtic Woman
Cactus - TWICE
.